111111111111111111111111111111111111
11                                11
11                                11
11          22 11 22 11           11
112222                            11
11                                11
11                                11
11       1    1  1  2  2          11
11                                11
11                                11
11                         3333   11
11                       3        11
11 4444  44  11         3         11
11             2 2 2 3 3          11
11                                11
11                                11
11                                11
1111  2 2 2 2222       1 1 1 1222211
11          1                     11
11          1                     11
11          1                     11
11          222233333             11
1111                            1111
11                         11     11
11   3333                 222     11
11                      33333     11
11                    4444444     11
111111111111111111111111111111111111
