11        111111111111111       1111
11                                11
11                                11
11                                11
11                       2222     11
112222  222                       11
11                                11
11                              1111
11           1 2 1 2 1 2 1 2      11
1111                              11
11                                11
11                                11
1111                    2222    1111
11               11221111111      11
11             22                 11
1111                              11
11                                11
1111   111  22         11111    1111
11                                11
11                                11
11             222                11
11                                11
1111   1111          11111111   1111
11                                11
11                                11
11                                11
11                                11